11111111111111111111111111111111111111111111111
1000000000000000000000000000000000000P000000011
10100101001000001010010000000101000000000000011
10100100101010100010010000C001010000000E0000011
10000000000000000000000000000000000000000000011
11111111111111111111111111111111111111111111111