1111111111111
10010/00000C1
1000011111001
1P00111E00001
1111111111111